3333311111
1222210201
1000010201
1123312222
1221111022
1303001022
1033330000
1033330111
1100031021
3111111111
